
[
--------------------------------------------------------------------------------------------------------------------------------------------------------------------------------------| 
-                                                                                                                                                                                    -|
-                                                                                                                                                                                    -|
----                                                                                                                                                                         ---    --|
-            --                                                                                                                                                                      -|
-                                                                                                                                                                                    -|
-                                                                                                                                                                                    -|
-                                                                                                                                                                                    -|
--                                                                                                                                                                       ----        -|
-                                                                                                                                                                                    -|
--                                                                                                                                                                               --- -|
-                                                                                                                                                                                    -|
-                                                                                                                                                                                    -|
-                                                                                                                                                                                    -|
-                                                                                                                                                                                    -|
-      ---                                                                                                                                                                           -|
-                                                                                                                                                                                    -|
-   --------                                                                                                                                                            ----         -|
-                                                                                                                                                                                    -|
-                                                                                                                                                                             -      -|
-                                                                                                                                                                                --  -|
-                                                                                                                                                                                    -|
-                                                                                                                                                                                    -|
---------------                                                                                                                                                                  --  -|
-                                                                                                                                                                                    -|
-                                                                                                                          0                                                          -|
--------------------------------------------------------------------------------------------------------------------------------------------------------------------------------------|
--------------------------------------------------------------------------------------------------------------------------------------------------------------------------------------|
--------------------------------------------------------------------------------------------------------------------------------------------------------------------------------------|
--------------------------------------------------------------------------------------------------------------------------------------------------------------------------------------|
--------------------------------------------------------------------------------------------------------------------------------------------------------------------------------------|
--------------------------------------------------------------------------------------------------------------------------------------------------------------------------------------|
--------------------------------------------------------------------------------------------------------------------------------------------------------------------------------------|
--------------------------------------------------------------------------------------------------------------------------------------------------------------------------------------|
--------------------------------------------------------------------------------------------------------------------------------------------------------------------------------------|
--------------------------------------------------------------------------------------------------------------------------------------------------------------------------------------|
--------------------------------------------------------------------------------------------------------------------------------------------------------------------------------------|
--------------------------------------------------------------------------------------------------------------------------------------------------------------------------------------|
--------------------------------------------------------------------------------------------------------------------------------------------------------------------------------------| 
-                                                                                                                                                                                    -|
-                                                                                                                                                                                    -|
----                                                                                                                                                                         ---    --|
-            --                                                                                                                                                                      -|
-                                                                                                                                                                                    -|
-                                                                                                                                                                                    -|
-                                                                                                                                                                                    -|
--                                                                                                                                                                       ----        -|
-                                                                                                                                                                                    -|
--                                                                                                                                                                               --- -|
-                                                                                                                                                                                    -|
-                                                                                                                                                                                    -|
-                                                                                                                                                                                    -|
-                                                                                                                                                                                    -|
-      ---                                                                                                                                                                           -|
-                                                                                                                                                                                    -|
-   --------                                                                                                                                                            ----         -|
-                                                                                                                                                                                    -|
-                                                                                                                                                                             -      -|
-                                                                                                                                                                                --  -|
-                                                                                                                                                                                    -|
-                                                                                                                                                                                    -|
---------------                                                                                                                                                                  --  -|
-                                                                                                                                                                                    -|
-                                                                                                                          0                                                         -|
--------------------------------------------------------------------------------------------------------------------------------------------------------------------------------------|
]

player 500 500
portal 600 600 1600 1700



/
x1 = 600
y1 = 600
x2 = 1000
y2 = 1000